1111111111111
1001C00E00001
1000011111001
1P001100C0001
1111111111111