1111111111111
1PE00000C0001
1111111111111